{
  "maps": {
    "bun06": {
      "id": 8000,
      "wh": [13,15],
      "A1": 4,
      "B1": 3,
      "playerNum": 8,
      "playerBornPos":[[0,3],[0,3],[0,3],[0,3],[0,3],[0,3],[0,3],[0,3]],
      "layout0": [
      0,      0,      0,      0,      0,      0,      0,      0,      0,      0,      0,      0,      0,      0,      0,

      0,      0,      0,      0,      8009,   0,      0,      0,      8010,   0,      0,      0,      0,      0,      0,

      0,      0,      0,      0,      0,      0,      0,      0,      0,      0,      0,      0,      0,      0,      0,

      0,      0,      0,      0,      0,      0,      0,      0,      0,      0,      0,      0,      0,      0,      0,

      0,      0,      0,      0,      0,      0,      0,      0,      0,      0,      0,      0,      0,      0,      0,

      0,      0,      0,      0,      0,      0,      0,      0,      0,      0,      0,      0,      0,      0,      0,

      0,      0,      0,      0,      0,      0,      0,      0,      0,      0,      0,      0,      0,      0,      0,

      0,      0,      0,      0,      0,      0,      0,      0,      0,      0,      0,      0,      0,      0,      0,

      0,      0,      0,      0,      0,      0,      0,      0,      0,      0,      0,      0,      0,      0,      0,

      0,      0,      0,      0,      0,      0,      0,      0,      0,      0,      0,      0,      0,      0,      0,

      0,      0,      0,      0,      0,      0,      0,      0,      0,      0,      0,      0,      0,      0,      0,

      0,      0,      0,      0,      0,      0,      0,      0,      0,      0,      0,      0,      0,      0,      0,

      0,      0,      0,      0,      0,      0,      0,      0,      0,      0,      0,      0,      0,      0,      0


      ],

      "layout1": [
      8002,   8003,   0,      8002,   8001,   8003,   8002,   8005,   8003,   8003,   8002,   8002,   0,      8003,   8002,

      8002,   8003,   0,      8001,   0,      0,      0,      8005,   0,      0,      0,      8001,   0,      8003,   8003,

      0,      0,      0,      8002,   0,      0,      0,      8005,   0,      0,      0,      8002,   0,      0,      0,

      0,      0,      0,      8003,   0,      0,      0,      8005,   0,      0,      0,      8003,   0,      0,      0,

      0,      8003,   0,      8006,   0,      0,      0,      8006,   0,      0,      0,      8006,   0,      8002,   0,

      0,      8001,   8002,   0,      8001,   8001,   8002,   8005,   8002,   8001,   8002,   0,      8002,   8001,   0,

      0,      8001,   8001,   0,      8001,   8003,   8003,   8005,   8003,   8003,   8003,   0,      8002,   8002,   0,

      0,      0,      0,      8006,   8005,   0,      0,      8006,   0,      0,      8005,   8006,   0,      0,      0,

      0,      8006,   8005,   8005,   8004,   8005,   8005,   8004,   8005,   8005,   8005,   8004,   8005,   8006,   0,

      0,      0,      8002,   8001,   8001,   8001,   8001,   8001,   8002,   8001,   8002,   8001,   8002,   0,      0,

      0,      8001,   8001,   8001,   8001,   8002,   8001,   8002,   8001,   8001,   8001,   8002,   8001,   8001,   0,

      0,      8012,   8002,   8012,   8012,   8001,   8012,   8012,   8012,   8002,   8012,   8002,   8012,   8012,   0,

      8012,   8012,   8012,   8012,   8004,   8003,   8012,   8012,   8004,   8003,   8012,   8003,   8004,   8012,   8012


      ],

      "layout2": [
      8011,   8011,   8011,   8011,   8011,   8011,   8011,   8011,   8011,   8011,   8011,   8011,   8011,   8011,   8011,

      8011,   8011,   8011,   8011,   8011,   8011,   8011,   8011,   8011,   8011,   8011,   8011,   8011,   8011,   8011,

      8011,   8011,   8011,   8011,   8011,   8011,   8011,   8011,   8011,   8011,   8011,   8011,   8011,   8011,   8011,

      8011,   8011,   8011,   8011,   8011,   8011,   8011,   8011,   8011,   8011,   8011,   8011,   8011,   8011,   8011,

      8011,   8011,   8011,   8011,   8011,   8011,   8011,   8011,   8011,   8011,   8011,   8011,   8011,   8011,   8011,

      8011,   8011,   8011,   8011,   8011,   8011,   8011,   8011,   8011,   8011,   8011,   8011,   8011,   8011,   8011,

      8011,   8011,   8011,   8011,   8011,   8011,   8011,   8011,   8011,   8011,   8011,   8011,   8011,   8011,   8011,

      8011,   8011,   8011,   8011,   8011,   8011,   8011,   8011,   8011,   8011,   8011,   8011,   8011,   8011,   8011,

      8011,   8011,   8011,   8011,   8011,   8011,   8011,   8011,   8011,   8011,   8011,   8011,   8011,   8011,   8011,

      8011,   8011,   8011,   8011,   8011,   8011,   8011,   8011,   8011,   8011,   8011,   0,      0,      0,      0,

      8011,   8013,   8011,   8011,   8011,   8011,   8011,   8011,   8011,   8011,   0,      0,      0,      0,      0,

      8011,   8011,   8011,   8011,   8011,   8011,   8011,   8011,   8011,   8011,   8011,   8011,   8011,   8011,   8011,

      8011,   8011,   8011,   8011,   8011,   8011,   8011,   8011,   8011,   8011,   8011,   8011,   8011,   8011,   8011
      ],
      "res": {
        "textureSetNum" : 2,
        "textureSetPath" : "2d/texture/",
        "bgmPath":  "audio/music/bun.ogg"
      }
    }
  }
}